07 07 07 07 07 07 07 07 07 07 07 07 07 07 07 07 07 07 07 07 07 07 07 07 07 07 07 07 07 07 07 07 07 07 07 07 07 07 07 07 07 07 07 07 07 07 07 07 07 07
07 07 07 07 07 07 07 07 07 07 07 07 07 07 07 07 07 07 07 07 07 07 07 07 07 07 07 07 07 07 07 07 07 07 07 07 07 07 07 07 07 07 07 07 07 07 09 09 07 07
07 07 13 00 00 00 00 00 00 00 00 00 00 14 07 07 07 07 07 07 07 07 07 07 07 07 07 07 07 07 07 07 07 07 09 09 09 09 09 09 09 09 09 09 09 09 09 09 07 07
07 07 12 09 09 09 09 09 09 09 09 09 09 15 07 07 07 07 07 07 07 07 07 07 07 07 07 07 07 07 07 07 07 07 09 07 07 07 07 07 07 07 07 07 07 07 09 09 07 07
07 07 12 09 09 09 09 09 09 09 09 09 09 15 07 07 07 07 07 07 07 07 07 07 07 07 07 07 07 07 07 07 07 07 09 07 07 07 07 07 07 07 07 07 07 07 07 07 07 07
07 07 12 09 09 09 09 09 09 09 09 09 09 15 07 07 07 07 07 07 07 07 07 07 07 07 07 07 09 09 09 09 09 09 09 07 07 07 07 07 07 07 07 07 07 07 07 07 07 07
07 07 12 09 09 09 09 09 09 09 09 09 09 15 07 07 07 07 07 07 07 07 07 07 07 07 07 07 09 07 07 07 07 07 09 07 07 07 07 07 07 07 07 07 07 07 07 07 07 07
07 07 12 09 09 09 09 09 10 09 09 09 09 15 09 09 09 09 09 09 09 09 09 07 07 07 07 07 09 07 07 07 07 07 09 07 07 07 07 07 07 07 07 07 07 07 07 07 07 07
07 07 12 09 09 02 03 03 10 03 03 04 09 15 09 09 09 09 09 09 09 09 09 07 07 07 07 07 09 07 07 07 07 07 09 07 07 07 07 07 07 07 07 07 07 07 07 07 07 07
07 07 12 09 09 01 06 06 10 06 06 05 09 15 09 09 09 09 09 09 09 09 09 07 07 07 07 07 09 07 07 07 07 07 09 07 07 07 07 07 07 07 07 07 07 07 07 07 07 07
07 07 12 09 09 01 06 06 10 06 06 05 09 15 09 09 09 09 09 09 09 09 09 07 07 07 07 07 09 07 07 07 07 07 09 07 07 07 07 07 07 07 07 07 07 07 07 07 07 07
07 07 12 09 09 01 06 06 10 06 06 05 09 15 09 09 09 09 09 09 09 09 09 07 07 07 07 07 09 07 07 07 07 07 09 09 09 09 09 09 09 09 09 09 09 09 09 09 07 07
07 07 12 09 09 01 06 06 10 06 06 05 09 15 09 09 09 09 09 09 09 09 09 07 07 07 07 07 09 07 07 07 07 07 07 07 07 07 07 07 07 07 07 07 07 07 07 09 07 07
07 07 12 09 09 01 06 06 10 06 06 05 09 15 09 09 09 09 09 09 09 09 09 07 07 07 07 07 09 09 09 09 09 09 09 07 07 07 07 07 07 07 07 07 07 07 07 09 07 07
07 07 16 00 00 00 00 00 08 00 00 00 00 17 09 09 09 09 09 09 09 09 09 07 07 07 07 07 07 07 07 07 07 07 09 07 07 07 07 07 07 07 07 07 07 07 07 09 07 07
07 07 09 09 09 09 09 09 08 09 09 09 09 09 09 09 09 09 09 09 09 09 09 07 07 07 07 07 07 07 07 07 07 07 09 07 07 07 07 07 07 07 07 07 07 07 07 09 07 07
07 07 09 09 09 09 09 09 08 09 09 09 09 09 09 09 09 09 09 09 09 09 09 07 07 07 07 07 07 07 09 07 07 07 09 07 07 07 07 07 07 07 07 07 07 07 07 09 07 07
07 07 09 09 09 09 09 09 08 09 09 09 09 09 09 09 09 09 09 09 09 09 09 07 07 07 07 07 07 07 09 07 07 07 09 07 07 07 07 07 07 07 07 07 07 07 07 09 07 07
07 07 09 09 09 09 09 09 08 09 09 09 09 09 09 09 09 09 09 09 09 09 09 07 07 07 07 07 07 07 09 09 09 09 09 07 02 03 03 03 03 03 03 03 04 07 07 09 07 07
07 07 09 09 09 09 09 09 08 09 09 09 09 09 09 09 09 09 09 09 09 09 09 07 07 07 07 07 07 07 09 07 07 07 07 07 01 06 06 06 06 06 06 06 05 07 07 09 07 07
07 07 09 09 09 09 09 09 08 08 08 08 08 08 08 08 08 08 08 08 08 08 08 09 09 09 09 09 09 09 09 09 09 09 07 07 01 06 06 09 09 09 06 06 05 07 07 09 07 07
07 07 09 09 09 09 09 09 09 09 09 09 08 09 09 09 09 09 09 09 08 09 09 07 07 07 07 07 07 09 07 07 07 07 07 07 01 06 06 09 09 09 06 06 05 07 07 09 07 07
07 07 09 09 09 09 09 09 09 09 09 09 08 09 09 09 09 09 09 09 08 09 09 07 07 07 07 07 07 09 07 07 07 07 07 07 01 06 06 09 09 09 06 06 05 07 07 09 07 07
07 07 09 09 09 09 09 09 09 09 09 09 08 09 09 09 09 09 09 09 08 09 09 07 07 07 07 07 07 09 07 07 07 07 07 07 01 06 06 06 10 06 06 06 05 07 07 09 07 07
07 07 09 09 09 09 09 09 09 09 09 09 08 09 09 09 09 07 07 09 08 09 09 07 07 07 07 07 07 09 07 07 07 07 07 07 01 06 06 06 10 06 06 06 05 07 07 09 07 07
07 07 09 09 09 09 09 09 09 09 09 09 08 09 09 07 07 07 09 09 08 09 09 07 07 07 07 07 07 09 07 07 07 07 07 07 01 06 06 06 10 06 06 06 05 07 07 09 07 07
07 07 09 09 09 09 09 09 09 09 09 09 08 09 09 07 09 09 09 09 08 09 09 07 07 07 07 07 07 09 09 09 09 09 09 09 07 07 07 07 09 07 07 07 07 07 07 09 07 07
07 07 09 09 09 09 09 09 09 09 09 09 08 09 09 07 07 07 09 09 08 09 09 07 07 07 07 07 07 09 07 07 07 07 07 07 07 07 07 07 09 07 09 07 07 07 07 09 07 07
07 07 09 09 09 09 09 09 09 09 09 09 08 09 09 09 09 09 09 09 08 09 09 07 07 07 07 07 07 09 07 07 07 07 07 07 07 07 07 07 09 09 09 07 07 07 07 09 07 07
07 07 09 09 09 09 09 09 09 09 09 09 08 09 09 09 09 09 09 09 08 09 09 07 07 07 07 07 07 09 07 07 07 07 07 07 07 07 07 07 07 07 09 07 07 07 07 09 07 07
07 07 09 09 09 09 09 09 09 09 09 09 08 09 09 09 09 09 09 09 08 09 09 07 07 07 07 07 07 09 07 07 07 07 07 07 07 07 07 07 07 07 09 07 07 07 07 09 07 07
07 07 09 09 09 09 09 09 09 09 09 09 08 09 09 09 09 07 07 09 08 09 09 07 07 07 09 09 09 09 07 07 07 07 07 07 07 09 07 07 07 07 09 07 07 07 07 09 07 07
07 07 09 09 09 09 09 09 09 09 09 09 08 09 09 09 09 09 09 09 08 09 09 07 07 07 09 07 07 07 07 07 07 07 07 07 07 09 07 07 07 07 09 07 07 07 07 09 07 07
07 07 09 09 09 09 09 09 09 09 09 09 08 09 09 09 09 09 09 09 08 09 09 07 07 07 09 07 07 07 07 07 07 07 07 07 07 09 07 07 07 07 09 07 07 07 07 09 07 07
07 07 09 09 09 09 09 09 09 09 09 09 08 09 09 09 09 09 09 09 08 09 09 07 07 07 09 07 07 07 07 07 07 07 07 07 07 09 07 07 07 07 09 07 07 07 07 09 07 07
07 07 09 09 09 09 09 09 09 09 09 09 08 09 09 09 09 09 09 09 08 09 09 07 07 07 09 07 07 07 07 07 07 07 07 07 07 09 07 07 07 07 09 07 07 07 07 09 07 07
07 07 09 09 09 09 09 09 09 09 09 09 08 09 09 09 09 09 09 09 08 09 09 07 07 07 09 07 07 07 07 07 07 07 07 07 09 09 09 09 09 09 09 07 07 07 07 09 07 07
07 07 09 09 09 09 09 09 09 09 09 09 08 09 09 09 09 09 09 09 08 09 09 07 07 07 09 07 09 07 09 09 09 09 07 07 09 07 07 07 07 07 09 07 07 07 07 09 07 07
07 07 09 09 09 09 09 09 09 09 09 09 08 09 09 09 09 09 09 09 08 09 09 07 07 07 09 07 09 07 09 07 07 09 07 07 09 07 07 07 07 07 09 07 07 07 07 09 07 07
07 07 09 09 09 09 09 09 09 09 09 09 08 08 08 08 08 08 08 08 08 09 09 07 07 07 09 09 09 07 09 07 07 09 07 07 09 07 07 07 07 07 09 07 07 07 07 09 07 07
03 03 03 03 03 03 03 03 03 03 03 04 09 09 09 09 09 09 08 09 09 09 09 07 07 07 07 09 07 07 09 07 07 09 07 07 09 07 07 07 07 07 09 07 07 07 07 09 07 07
06 06 06 06 06 06 06 06 06 06 06 05 09 09 09 09 09 09 08 09 09 09 09 07 07 07 07 09 07 07 09 07 07 09 07 07 09 07 07 07 07 07 09 07 07 07 07 09 07 07
06 06 06 06 06 06 06 06 06 06 06 05 09 09 09 09 09 09 08 09 09 09 09 07 07 07 07 09 07 07 09 07 07 09 07 07 09 07 07 07 07 07 09 07 07 07 07 09 07 07 
06 06 06 06 06 06 06 06 06 06 06 05 08 08 08 08 08 08 08 09 09 09 09 07 07 07 07 09 07 07 09 07 09 09 07 07 09 07 07 07 07 07 09 09 09 09 09 09 07 07
06 06 06 06 06 06 06 06 06 06 06 05 08 09 09 09 09 09 08 08 08 08 08 07 07 07 07 09 07 07 09 07 07 07 07 07 09 07 07 07 07 07 07 07 07 07 07 07 07 07
06 06 06 06 06 06 06 06 06 06 06 05 08 09 09 09 09 09 08 09 09 09 09 07 07 07 07 09 07 07 09 07 07 07 07 07 09 07 07 07 07 07 07 07 07 07 07 07 07 07
06 06 06 06 06 06 06 06 06 06 06 05 08 09 09 09 09 09 08 09 09 09 09 07 07 07 07 09 07 07 09 09 09 09 09 09 09 07 07 07 07 07 07 07 07 07 07 07 07 07
06 06 06 06 06 06 06 06 06 06 06 05 08 08 08 08 08 08 08 08 08 08 08 07 07 07 07 07 07 07 09 07 07 07 07 07 07 07 07 07 07 07 07 07 07 07 07 07 07 07 
06 06 06 06 06 06 06 06 06 06 06 05 07 07 07 07 07 07 07 07 07 07 07 07 07 07 07 07 07 07 07 07 07 07 07 07 07 07 07 07 07 07 07 07 07 07 07 07 07 07 
06 06 06 06 06 06 06 06 06 06 06 05 07 07 07 07 07 07 07 07 07 07 07 07 07 07 07 07 07 07 07 07 07 07 07 07 07 07 07 07 07 07 07 07 07 07 07 07 07 07 